type octile
height 3
width 20
map
...@@@@@@@@@@@@@@...
....................
...@@@@@@@@@@@@@@...