type octile
height 2
width 7
map
@@@@.@@
.......